rxxxxxxr
x      x
x l    x
x  b   x
x      x
rxxxxxxr
---
xxxxxxxx
x p    x
x b  g x
x b  g x
x      x
xxxxxxxx
---
xxxxxxxx
x      x
x p  b x
x  b g x
x    g x
xxxxxxxx
---
xxxxxxxx
x p    x
x      x
x b  g x
x      x
xxxxxxxx


